111111111111
1P00C0CC0011
10000C00X0C1
111111111111