1111111111111
1X00000000001
1111111111101
110000C000101
1101111110101
1101P00000101
1101111111101
1100000000001
1111111111111